 #  ##   ## ##  ### ###  ## # # ###  ## # # #   # # ###  #  ##   #  ##   ## ### # # # # # # # # # # ### ### 
# # # # #   # # #   #   #   # #  #    # # # #   ### # # # # # # # # # # #    #  # # # # # # # # # #   #   # 
### ##  #   # # ##  ##  # # ###  #    # ##  #   ### # # # # ##  # # ##   #   #  # # # # ###  #   #   #   ## 
# # # # #   # # #   #   # # # #  #  # # # # #   # # # # # # #    ## # #   #  #  # # # # ### # #  #  #       
# # ##   ## ##  ### #    ## # # ###  #  # # ### # # # #  #  #     # # # ##   #  ###  #  # # # #  #  ###  #  