# # ### ### # # ### ### ### ### ### 
###   # # # # #   #  #   #    # # # 
###  ## # # ###  ##  #   #   ## # # 
# #     # # # #      #   #      # # 
# #  #  # # # #  #   #   #   #  # # 